111111111111111111111111111111111111111111
100000000000000000000000000000000000000011
100000000000000000000000000000000000000011
100000000000000000000000000000000000000011
100000000000000000000000000000000000000011
1000000000000000000E0000000000000000000011
100000000000000000000000000000000000000000
100000000000000000000000000000000000000011
100000000000000000000000P00000000000000011
1000000000000000C0000000000000000000000011
100000000000000000000000000000000000000011
100000000000000000000000000000000000000011
111111111111111111111111111111111111111111