111111111111111111111
100000000000000000001
100000000000000000001
1000000000000000C0001
100000000000000000001
100000000000000000001
100000000000000000001
100000000000P00000001
100000000000C00000001
100000000000000000001
100000000000000000001
100000000000000000001
100000000000000000001
100000000000000000001
111111111111111111111
