111111111111111111111
100010000000000000001
100CE1000000000010001
1000100000000001C1001
100000000000000000001
100000000000000000001
100000000000000000001
100000000000P00000001
100000000000C00000001
100000000000000000001
100000000000000000001
100000000000000000001
100000000000000000001
100000000000000000001
111111111111111111111
