111111111111111111111
100011000000000111001
1000E1000000000111001
1000110000000001C1001
100000000000000000001
100000000000000000001
100000000000000000001
100000000000P00000001
100000000000C00000001
100000000001000000001
100000000001000000001
100000000001000000001
100000000001000000001
100000000001000000001
111111111111111111111
